               '旼컴컴컴컴컴컴컴컴컴컴컴컴컴컴컴컴컴컴컴컴커'
                 **********:::::: Greets ::::::********** 
                 컴컴컴컴컴컴컴컴컴컴컴컴컴컴컴컴컴컴컴컴 
                 ******* -= Vx United Isuue #2 =- ******* 
               '읕컴컴컴컴컴컴컴컴컴컴컴컴컴컴컴컴컴컴컴컴켸'


	I'd just like to say thanks to everyone who contributed to this issue.
To those who helped out again from last issue, and for those who were planning
on adding to this, but never got around to it like so often the case is. Time
is a pain hu?


ANAkTAS   - So when are we gonna get those spl tuts?
Buz       - [FS]!!! You made it! thanks, for help and inspiration.
b0z0      - Havent seen you around for a while, Long live ikx.
cicatrix  - Glad you decided to stick around. VDAT's time is not up.,
drdope    - Where did you slip away to?
Opic      - Who else would i go whining to when i can't get something to work?
CyberYoda - Move back here... and keep pockies from putting you in his ear.
CoKe      - Go back to your place in the scene, you know where you belong. =]
darkman   - One day you will be a pr0nking too. Thanks for everything man.
forms     - Figured it was best if i stuck your name in here next to darkman.
Fayte     - Welcome back, glad your outta jail. 6 months hurts hu? Don't fuck up
Foxz      - Good job with the NoMercy crew..
GriYo     - Sorry you didnt have time, maybe we can work something out for #3
Horny Toad- Keep cranking out those tuts. You have help a lot of people.
Infidel   - nUcLeii squirms. uNF!
Jtr       - You saw the zine, now see the server! SOK is back in action!
Jacky Qwerty- Its nice to see you old school kids hanging around.
KilJaeden - Your asm progressed so fast, it was weird...
knowdeth  - Youve been down from the start of this project.Like a brother to me.
lord julus- I don't know you but i like your tuts. 
lordnatas - Keep your packets to yourself., ehehe,.
Madhatter - We gotta get the guild going again,,.
MadMan    - uNF! uNF! uNF!... again. =]
mmir      - Nice to meet you, hope to see you around again sometime.
Mr Sandman- You departed from 29a, but where the hell did you go? Mail me hu?
mgl       - Is the next issue of Asterix ever gonna come out?
N. Joker  - Welcome back to the scene, good luck with sos.
Owl       - Hoot! maybe #3? =]
Pockets   - Quit putting CyberYoda in your ear... and no squashing either.,
Prometh   - Life., geeze,.
poltergst - polt!
"Q"       - I can't thank you enough, its been great to have you back in #2.
Rajaat    - I never did understand some of those crazy engines you cranked out.
RAiD      - Gotta love the constant battles with the av'ers in a.c.v., keep your
            head up man.,
Random    - We gotta spin records sometime,. You win the #vir idle award.
reptile   - Calm down. ehhe.,
Rod       - Who's my fuzzy wittle av'er,. awww., aint that cute.
ru686     - The numbers change almost every time, i dunno what to put.
SBlip     - *BLiP*
Sea4      - Haven't seen you around for a while either... contact me.
SinixstaR - Sometime in D.C...hehe., we should have seen Kemistry&Storm.
Spooky    - When are you gonna burn me cd's of your collection? ,.eheh.,
Superx    - All you crazy 29a kids,. geeze.,
T-2000    - Thanks for the massive contribution.
technophn - y3w l337 h4x0r y3w. Good luck with your new group. whatsitcalled.
UK        - Welcome to the guild.
urgo32    - See ya on irc.
Vecna     - Wish you would have been in this issue also,.
VicodinES - Did you leave again or not?
Virtual Daemon - Come on and start being "active" again.
virogen   - Lets see something crazy come outta nop... a great inspiration.
yesna     - Sorry, i didnt have time to harass you enough for help. eheh,.
Yosha     - I dunno what to say to you besides hello.,. eheh.,

And greets going out to:
29a,CodeBreakers,FS,ikx,metaphase,nomercy,nop,SLAM,sos, and all the long
abandoned groups and writers from yesterday,., you can't forget your past.

                               Much Respect.
                                      nUcLeii
